{
    "name":"Desert Loop",
    "src":"img/Map.png",
    "path":[
        {
            "x": 264,
            "y": 567
        },
        {
            "x": 263,
            "y": 344
        },
        {
            "x": 73,
            "y": 343
        },
        {
            "x": 71,
            "y": 440
        },
        {
            "x": 168,
            "y": 440
        },
        {
            "x": 166,
            "y": 72
        },
        {
            "x": 70,
            "y": 71
        },
        {
            "x": 71,
            "y": 169
        },
        {
            "x": 439,
            "y": 168
        },
        {
            "x": 440,
            "y": 70
        },
        {
            "x": 345,
            "y": 71
        },
        {
            "x": 346,
            "y": 264
        },
        {
            "x": 537,
            "y": 262
        }
    ],
    "tile":{
        "width":16,
        "height":16
    },
    "width":32,
    "height":32,
    "placement":[0, 0, 0, 0, 0, 0, 0, 0, 0, 0, 0, 0, 0, 0, 0, 0, 0, 0, 0, 0, 0, 0, 0, 0, 0, 0, 0, 0, 0, 0, 0, 0,
    0, 0, 0, 0, 0, 0, 0, 0, 0, 0, 0, 0, 0, 0, 0, 0, 0, 0, 0, 0, 0, 0, 0, 0, 0, 0, 0, 0, 0, 0, 0, 0,
    0, 0, 0, 0, 0, 0, 0, 0, 0, 0, 0, 0, 0, 0, 0, 0, 0, 0, 0, 0, 0, 0, 0, 0, 0, 0, 0, 0, 0, 0, 0, 0,
    0, 0, 0, 1397, 1397, 1397, 1397, 1397, 1397, 1397, 1397, 1397, 0, 0, 0, 0, 0, 0, 0, 0, 1397, 1397, 1397, 1397, 1397, 1397, 1397, 1397, 1397, 0, 0, 0,
    0, 0, 0, 1397, 1397, 1397, 1397, 1397, 1397, 1397, 1397, 1397, 0, 0, 0, 0, 0, 0, 0, 0, 1397, 1397, 1397, 1397, 1397, 1397, 1397, 1397, 1397, 0, 0, 0,
    0, 0, 0, 1397, 1397, 1397, 1397, 1397, 1397, 1397, 1397, 1397, 0, 0, 0, 0, 0, 0, 0, 0, 1397, 1397, 1397, 1397, 1397, 1397, 1397, 1397, 1397, 0, 0, 0,
    0, 0, 0, 1397, 1397, 1397, 0, 0, 0, 1397, 1397, 1397, 0, 0, 0, 0, 0, 0, 0, 0, 1397, 1397, 1397, 0, 0, 0, 1397, 1397, 1397, 0, 0, 0,
    0, 0, 0, 1397, 1397, 1397, 0, 0, 0, 1397, 1397, 1397, 0, 0, 0, 0, 0, 0, 0, 0, 1397, 1397, 1397, 0, 0, 0, 1397, 1397, 1397, 0, 0, 0,
    0, 0, 0, 1397, 1397, 1397, 0, 0, 0, 1397, 1397, 1397, 0, 0, 0, 0, 0, 0, 0, 0, 1397, 1397, 1397, 0, 0, 0, 1397, 1397, 1397, 0, 0, 0,
    0, 0, 0, 1397, 1397, 1397, 1397, 1397, 1397, 1397, 1397, 1397, 1397, 1397, 1397, 1397, 1397, 1397, 1397, 1397, 1397, 1397, 1397, 1397, 1397, 1397, 1397, 1397, 1397, 0, 0, 0,
    0, 0, 0, 1397, 1397, 1397, 1397, 1397, 1397, 1397, 1397, 1397, 1397, 1397, 1397, 1397, 1397, 1397, 1397, 1397, 1397, 1397, 1397, 1397, 1397, 1397, 1397, 1397, 1397, 0, 0, 0,
    0, 0, 0, 1397, 1397, 1397, 1397, 1397, 1397, 1397, 1397, 1397, 1397, 1397, 1397, 1397, 1397, 1397, 1397, 1397, 1397, 1397, 1397, 1397, 1397, 1397, 1397, 1397, 1397, 0, 0, 0,
    0, 0, 0, 0, 0, 0, 0, 0, 0, 1397, 1397, 1397, 0, 0, 0, 0, 0, 0, 0, 0, 1397, 1397, 1397, 0, 0, 0, 0, 0, 0, 0, 0, 0,
    0, 0, 0, 0, 0, 0, 0, 0, 0, 1397, 1397, 1397, 0, 0, 0, 0, 0, 0, 0, 0, 1397, 1397, 1397, 0, 0, 0, 0, 0, 0, 0, 0, 0,
    0, 0, 0, 0, 0, 0, 0, 0, 0, 1397, 1397, 1397, 0, 0, 0, 0, 0, 0, 0, 0, 1397, 1397, 1397, 0, 0, 0, 0, 0, 0, 0, 0, 0,
    0, 0, 0, 0, 0, 0, 0, 0, 0, 1397, 1397, 1397, 0, 0, 0, 0, 0, 0, 0, 0, 1397, 1397, 1397, 1397, 1397, 1397, 1397, 1397, 1397, 1397, 1397, 1397,
    0, 0, 0, 0, 0, 0, 0, 0, 0, 1397, 1397, 1397, 0, 0, 0, 0, 0, 0, 0, 0, 1397, 1397, 1397, 1397, 1397, 1397, 1397, 1397, 1397, 1397, 1397, 1397,
    0, 0, 0, 0, 0, 0, 0, 0, 0, 1397, 1397, 1397, 0, 0, 0, 0, 0, 0, 0, 0, 1397, 1397, 1397, 1397, 1397, 1397, 1397, 1397, 1397, 1397, 1397, 1397,
    0, 0, 0, 0, 0, 0, 0, 0, 0, 1397, 1397, 1397, 0, 0, 0, 0, 0, 0, 0, 0, 0, 0, 0, 0, 0, 0, 0, 0, 0, 0, 0, 0,
    0, 0, 0, 0, 0, 0, 0, 0, 0, 1397, 1397, 1397, 0, 0, 0, 0, 0, 0, 0, 0, 0, 0, 0, 0, 0, 0, 0, 0, 0, 0, 0, 0,
    0, 0, 0, 1397, 1397, 1397, 1397, 1397, 1397, 1397, 1397, 1397, 1397, 1397, 1397, 1397, 1397, 1397, 0, 0, 0, 0, 0, 0, 0, 0, 0, 0, 0, 0, 0, 0,
    0, 0, 0, 1397, 1397, 1397, 1397, 1397, 1397, 1397, 1397, 1397, 1397, 1397, 1397, 1397, 1397, 1397, 0, 0, 0, 1397, 1397, 1397, 0, 0, 0, 0, 0, 0, 0, 0,
    0, 0, 0, 1397, 1397, 1397, 1397, 1397, 1397, 1397, 1397, 1397, 1397, 1397, 1397, 1397, 1397, 1397, 0, 0, 0, 1397, 1397, 1397, 1397, 1397, 1397, 1397, 1397, 1397, 1397, 1397,
    0, 0, 0, 1397, 1397, 1397, 0, 0, 0, 1397, 1397, 1397, 0, 0, 0, 1397, 1397, 1397, 0, 0, 0, 1397, 1397, 1397, 1397, 1397, 1397, 1397, 1397, 1397, 1397, 1397,
    0, 0, 0, 1397, 1397, 1397, 0, 0, 0, 1397, 1397, 1397, 0, 0, 0, 1397, 1397, 1397, 0, 0, 0, 1397, 1397, 1397, 1397, 1397, 1397, 1397, 1397, 1397, 1397, 1397,
    0, 0, 0, 1397, 1397, 1397, 0, 0, 0, 1397, 1397, 1397, 0, 0, 0, 1397, 1397, 1397, 0, 0, 0, 1397, 1397, 1397, 1397, 1397, 1397, 1397, 1397, 1397, 1397, 1397,
    0, 0, 0, 1397, 1397, 1397, 1397, 1397, 1397, 1397, 1397, 1397, 0, 0, 0, 1397, 1397, 1397, 0, 0, 0, 1397, 1397, 1397, 1397, 1397, 1397, 1397, 1397, 1397, 1397, 1397,
    0, 0, 0, 1397, 1397, 1397, 1397, 1397, 1397, 1397, 1397, 1397, 0, 0, 0, 1397, 1397, 1397, 0, 0, 0, 0, 1397, 1397, 1397, 1397, 1397, 1397, 1397, 1397, 1397, 1397,
    0, 0, 0, 1397, 1397, 1397, 1397, 1397, 1397, 1397, 1397, 1397, 0, 0, 0, 1397, 1397, 1397, 0, 0, 0, 0, 1397, 1397, 1397, 1397, 1397, 1397, 1397, 1397, 1397, 1397,
    0, 0, 0, 0, 0, 0, 0, 0, 0, 0, 0, 0, 0, 0, 0, 1397, 1397, 1397, 0, 0, 0, 0, 1397, 1397, 1397, 1397, 1397, 1397, 1397, 1397, 1397, 1397,
    0, 0, 0, 0, 0, 0, 0, 0, 0, 0, 0, 0, 0, 0, 0, 1397, 1397, 1397, 0, 0, 0, 0, 1397, 1397, 1397, 1397, 1397, 1397, 1397, 1397, 1397, 1397,
    0, 0, 0, 0, 0, 0, 0, 0, 0, 0, 0, 0, 0, 0, 0, 1397, 1397, 1397, 0, 0, 0, 0, 1397, 1397, 1397, 1397, 1397, 1397, 1397, 1397, 1397, 1397]
}